55555555555555555555
51111101011010111115
51010101011010101015
51010101011010101015
51010101011010101015
51010111111111101015
21010111555511101013
51010111111111101015
51010101011010101015
51010101011010101015
51010101011010101015
51111101011010111115
55555555555555555555
