00000000000000000000
21011101111011101110
01010101011010101010
01010101011010101010
01010101011010101010
01010101011010101010
01010101011010101010
01010101011010101010
01010101011010101010
01010101011010101010
01010101011010101010
01010101011010101010
01010101011010101010
01110111011110111013
00000000000000000000
